a00000000#
am0000000#
a00000000#
a00000000#
a00000000#
ak0000000#
a00000000#
a00000000#
ak0000000#
a00000000#
a00000000#
a00000000#
a00000000#
ak0000000#
a00000000#
a00000000#
a00000000#
a00000000#
a00000000#
a00000000#